<><><><><><><><><><><><><><><><><><><><>
|//////////////////////////////////////|
|/LVL:////////////////LVL://///////////|
|/HP://///////////////HP://////////////|
|//////////////////////////////////////|
|                  //                  |
|                  //                  |
|                  //                  |
|                  //                  |
|                  //                  |
|                  //                  |
|                  //                  |
|                  //                  |
|--------------------------------------|
|~~~~~~~~~~~~~~~~~~~~~~~~~~~~~~~~~~~~~~|
|~~~~~~~~~~~~~~~~~~~~~~~~~~~~~~~~~~~~~~|
|~~~~~~~~~~~~~~~~~~~~~~~~~~~~~~~~~~~~~~|
|~~~~~~~~~~~~~~~~~~~~~~~~~~~~~~~~~~~~~~|
|~~~~~~~~~~~~~~~~~~~~~~~~~~~~~~~~~~~~~~|
<><><><><><><><><><><><><><><><><><><><>
