++++++++++++++++++++++++++++++++++++++++
+                                      +
+ ++++++++++++++++++++++++++++++++++++ +
+ +----------------------------------+ +
+ +--NAME:--------------LVL:---------+ +
+ +----------------------------------+ +
+ +---------------------EXP:---------+ +
+ +----------------------------------+ +
+ +----------------------------------+ +
+ +----------------------------------+ +
+ +---------------------HP:----------+ +
+ +----------------------------------+ +
+ +---------------------POWER:-------+ +
+ +----------------------------------+ +
+ +----------------------------------+ +
+ ++++++++++++++++++++++++++++++++++++ +
+                                      +
+                                      +
+                                      +
++++++++++++++++++++++++++++++++++++++++
