++++++++++++++++++++++++++++++++++++++++
+***          *******    ******** *****+
+* ** ***** * *                 *     *+
+*  * *   * * * *************** *******+
+*  * * * * * *      *        * *     *+
+** * * * * * * *** **** **** * * *** *+
+ * * *** * * * * * *  * *  * *** * * *+
+** *     * ***** ***  * * ** * * * * *+
+   ***** *            * *    * * *   *+
+** *   * * ---  ******* ****** * *****+
+  ***  * * -C- ** ** **   *    *      +
+ ** * ** * --- * ** ****************** 
+ *  * *  *  *  ** *      *****   *    +
+ *  * ******* * * *  ***  ************+
+ *  *         * * *  * * * ** *    * *+
+ ** ***************  * * * *  *  * * *+
+  **        *        *   ** * **** * *+
+   ******** ******* ****** **      * *+
+***                       ********** *+
++++++++++++++++++++++++++++++++++++++++

