++++++++++++++++++++++++++++++++++++++++
+--------------------------------------+
+--------------------------^-----------+
+---****------------------/ \----------+
+--********-------/=====\--:---~~~-----+
+-************---/_______\----~   ~----+
+---*******------(    [] )---~ ~  ~----+
+---********-----(       )----~  ~ ~---+
+----******------(_{}____)---~  ~ ~~---+
+-----------------*||-*-------~~~~-----+
+-^----*-*-*-*-*-*-*||-*------------^--+
+/ \----*-*-*-*-*-*-||*------------/ \-+
+-:----*-||||||||||||*-------------/ \-+
+-------*-*-*-*-*-*||-*-------****-/ \-+
+---^--*-*-*-*-*-*||-*-----*******--:--+
+--/ \----------*-||*----********------+
+--/ \-----------*||-*----******-------+
+---:-------------*||-*------*****-----+
+----------------*-||*-----------------+
+++++++++++++++++++  +++++++++++++++++++
