++++++++++++++++++++++++++  ++++++++++++
+-------------------------||-----------+
+---^---------------------||-----------+
+--/ \--------------------||-----**----+
+--/ \---|||||||||||||||||||----****---+
+--/ \---||----------------------****--+
+---:--***|-------^-------~~~~~~-------+
+-----*****------/ \---~~~ ~    ~~~----+
+------*******----:------~   ~~  ~-----+
+---******|*****----------~    ~  ~~---+
+----****||***---------~~~  ~~  ~ ~----+
 |||||*******--*---------~~~~~   ~~~---+
+--------||---***------------~~~~------+
+--------||||***|||||||----------------+
+----^------*****----||--^-------------+
+---/ \----*****-----||-/ \---****-----+
+---/ \-----******---||--:--*********--+
+----:-------****----||------******----+
+--------------------||-------***------+
+++++++++++++++++++++  +++++++++++++++++

