++++++++++++++++++++++++++++++++++++++++
+          +:::::::::::::::+           +
+          +::ASCII::HERO::+           +
+          +:::::::::::::::+           +
+ ++++++++++++++++++++++++++++++++++++ +
+ +----------------------------------+ +
+ +------------[CONTINUE]------------+ +
+ +----------------------------------+ +
+ +----------------------------------+ +
+ +-------------NEW-GAME-------------+ +
+ +----------------------------------+ +
+ +----------------------------------+ +
+ +---------------EXIT---------------+ +
+ +----------------------------------+ +
+ ++++++++++++++++++++++++++++++++++++ +
+                                      +
+              created by              +
+           Mateusz Wasowski           +
+                              v0.18   +
++++++++++++++++++++++++++++++++++++++++
