+++++++++++++++++++++  +++++++++++++++++
+--------------^---.-||-.--------------+
+---~~~~------/ \--.-||-.------~~------+
+--~~   ~~----/ \--.-||-.----~~  ~~----+
+--~~~~~~......:....-||-..~~~      ~---+
+--------.-----------||-----.-~     ~--+
+--------.-||||||||||||||||-.--~~~~~---+
+--------.-||||||||||||||||-.----------+
+--------.-||||||||||||||||-.----------+
+----^---.-||||||||||||||||-.----^-----+
+---/ \--.-||||||||||||||||-.---/ \----+
+---/ \--.-||||||||||||||||-.----:-----+
+---/ \--.-------\++/-----^-.----------+
+----:---........@..@..../ \.----------+
+---------------(----)---/ \-----------+
+--------^-----(>____<)--/ \-----------+
+-------/ \-----^^~~^^----:------------+
+--------:-----------------------------+
+--------------------------------------+
++++++++++++++++++++++++++++++++++++++++

