+++++++++++++++++++  +++++++++++++++++++
+------------------||------------------+
+---***------------||---*********------+
+---******---------||---***-*-***------+
+------*****-------||---*--***--*----^-+
+------------------||---***-*-***---/ \+
+-----|||||||||||||||---*********----:-+
+--^--||-------------------------------+
+-/ \-||--******************-----------+
+-/ \-||--*-*-*-*-*-*-*-*-*-------^----+
+-/ \-||---*-*-*-*-*-*-*-*-*-----/ \---+
+--:--||--******************------:----+
+-----||-------------------------------+
+-----||||||||||||||||||||||--*******--+
+-------------------------||--***-***--+
+---***------****---------||--*--*--*--+
+-***------*********------||--***-***--+
+---***-----*********-----||--*******--+
+-------------------------||-----------+
++++++++++++++++++++++++++  ++++++++++++

