++++++++++++++++++++++++++++++++++++++++
+--------------------------------------+
+--------------------------------------+
+---------------------------------/\---+
+--------------------------------/  \--+
+---(=======================)---/    \-+
+---(                       )-----::---+
+---(    "==="              )----------+
+---(                       )----------+
+---(   []___[]             )----------+
+---(                   D   )----------+
+---(      |||||||          )----------+
+---(      |||||||          )----------+
+---(  =]  |||||||          )----------+
+---(  =]  |||||||          )----------+
+---(  =]               /\  )----------+
+---(======{}===============)----------+
+--------*-||-*------------------------+
+-------*-*||*-*-----------------------+
++++++++++++++++++++++++++++++++++++++++

