++++++++++++++++++++++++++++++++++++++++
+                                      +
+ ++++++++++++++++++++++++++++++++++++ +
+ +----------------------------------+ +
+ +----------------------------------+ +
+ +----------------------------------+ +
+ +----------------------------------+ +
+ +----------------------------------+ +
+ +----------------------------------+ +
+ +----------------------------------+ +
+ +----------------------------------+ +
+ +----------------------------------+ +
+ +----------------------------------+ +
+ +----------------------------------+ +
+ ++++++++++++++++++++++++++++++++++++ +
+                                      +
+  And so your journey begins...       +
+                                      +
+                                      +
++++++++++++++++++++++++++++++++++++++++
